............###############################
............#.............................#
............#.............................#
............#.......####..................#
............#.............................#
#############......................!......#
#.....#...................####............#
#....@#...................#...............#
#.....#...1111.?..........#...............#
#.........................................#
#...........#........#....................#
#............#.............................#
#............#.............................#
#..#..#...................#............!..#
#...................!.....................#
#...............######....................#
#.........................................#
#....................###..................#
#......................#..................#
#.........................................#
###########################################