............###############################
............#.............................#
............#.............................#
............#.......####..................#
............#.............................#
#############.............................#
#.....#...................####............#
#....@#...................#...............#
#.....#.........!.........#...............#
#................!........................#
#............#....!........................#
#............#.............................#
#............#.............................#
#..#..#...................#...............#
#.........................................#
#...............######....................#
#.........................................#
#....................###..................#
#......................#..................#
#.........................................#
###########################################
...........................................
