............###############################
............#.............................#
............#....!........................#
............#.......####..................#
............#.............................#
#############......................!......#
#.....#...................####............#
#....@#...................#...............#
#.....#...1111.?..........#...............#
#.........................................#
#......................#..................#
#.........................................#
#.......!....!...!.....#.......!....!.....#
#.........................................#
#......................#..................#
#.........................................#
###########################################
